**********************
*s...........**s.....*
*............**......*
*............**......*
*............**......*
******..*********..***
*@....................
******..*********..***
*............**......*
*............**......*
*............**......*
*............**......*
*............**......*
*............**......*
*............**......*
**********************