**********************
*@.*......*...********
*.*..*.****.*.*......*
*...**......*...****.*
*.******.******....*.*
*...****s*....****.***
*.*....*.*.**....*...*
*.****.....*....**..**
*.**.*.****..**...*s.*
*..*.*...*s.**.....*.*
*....*.*.**.*..*.*.*.*
**.*.*.*..*...**...*.*
**.*....*...*.*..**..*
**.***.***..**.***..**
**s..*.....*.........
**********************