**********************
*............**......*
*............**......*
*............**......*
*............**......*
******..**************
*@....................
******..**************
*............**......*
*............**......*
*............**......*
*............**......*
*............**......*
*............**......*
*............**......*
**********************