**********************
*............**......*
*............**......*
*............**......*
*............**......*
******..**************
*.....................
******..**************
*............**......*
*............**......*
*............**......*
*............**......*
*............**......*
*............**......*
*............**......*
**********************