**********************
*@.*......*...********
*.*..*.****.*.*......*
*...**......*...****.*
*.******.******....*.*
*...****.*....****.***
*.*....*.*.**....*...*
*.****.....*....**..**
*.**.*.****..**...*..*
*..*.*...*..**.....*.*
*....*.*.**.*..*.*.*.*
**.*.*.*..*...**...*.*
**.*....*...*.*..**..*
**.***.***..**.***..**
**...*.....*.........u
**********************