**********************
*............**......*
*............**......*
*............**......*
*............**......*
******..*********..***
*@....................
******..*********..***
*............**......*
*............**......*
*............**......*
*............**......*
*............**......*
*............**......*
*............**......*
**********************