**********************
*....................u
****d************d****
*....................*
****d************d****
*....................*
****d************d****
*....................*
****d************d****
*....................*
****d************d****
*....................*
****d************d****
*....................*
h@...................*
**********************