**********************
h@...................*
********************.*
**.*.*.*.*.*.*.*.*.*.*
l1....t.......t......*
*.*.*.*.*.*.*.*.*.*.**
*.********************
*.*.**.**.**s**.**.***
*...t.......t......2r
**.**.**.**.**s**.**.*
********************.*
l1......t.......t....*
*.****s***.***.***.***
*.********************
*....................p
**********************