**********************
h@...................*
********************.*
**.*.*.*.*.*.*.*.*.*.*
l.....t...t...t......*
*.*.*.*.*.*.*.*.*.*.**
*.********************
*.*.**.**.**.**.**.***
*.....t......t.......r
**.**.**.**.**.**.**.*
********************.*
l.....t.......t......*
*.****.***.***.***.***
*.********************
*....................f
**********************