**********************
h@...................*
********************.*
**.*s*.*.*w*.*.*.*.*.*
l1....t.......t......*
*.*.*.*.*.*.*.*s*.*.**
*.********************
*.*.**.**s**.**.**.***
*...t.......t.......2r
**.**w**.**.**.**s**.*
********************.*
l1......t.......t....*
*.****s***.***w***.***
*.********************
*....................p
**********************