********************h*
********************.*
**.*s*.*.*w*.*.*.*.*.*
l2....t.......t......*
*.*.*.*.*.*.*.*.*.*.**
*.********************
*.*.**.**s**.**.**s***
*...t.......t.......1r
**.**w**.**.**.**.**.*
********************.*
l2......t.......t....*
*.****.***.***w***.***
*.********************
*...m...m...m...m...m*
*.....m...m...m...m..p
**********************