**********************
h@...................*
********************.*
**.*.*.*.*.*.*.*.*.*.*
l1....t...t...t......*
*.*.*.*.*.*.*.*.*.*.**
*.********************
*.*.**.**.**.**.**.***
*.....t......t......2r
**.**.**.**.**.**.**.*
********************.*
l1....t.......t......*
*.****.***.***.***.***
*.********************
*....................f
**********************