**********************
h@...................*
********************.*
**.*s*.*.*w*.*.*.*.*.*
l2....t.......t......*
*.*.*.*.*.*.*.*s*.*.**
*.********************
*.*.**.**s**.**.**.***
*...t.......t.......1r
**.**w**.**.**.**s**.*
********************.*
l2......t.......t....*
*.****s***.***w***.***
*.********************
*....................p
**********************