********************h*
********************.*
**.*s*.*.*w*.*.*.*.*.*
l2....t.......t......*
*.*.*.*.*.*.*.*.*.*.**
*.********************
*.*.**.**s**.**.**.***
*...t.......t.......1r
**.**w**.**.**.**.**.*
********************.*
l2......t.......t....*
*.****s***.***w***.***
*.********************
*...m...m...m...m...m*
*.....m...m...m...m..p
**********************