**********************
h@...................*
********************.*
**.*.*.*.*.*.*.*.*.*.*
w.....t...t...t......*
*.*.*.*.*.*.*.*.*.*.**
*.********************
*.*.**.**.**.**.**.***
*.....t......t.......w
**.**.**.**.**.**.**.*
********************.*
w.....t.......t......*
*.****.***.***.***.***
*.********************
*....................f
**********************